6
XX.XXX
X....X
..b...
X@...X
X....X
XX.XXX